1111111111111
1C1C000000001
100P011111C01
100C110E0C001
1111111111111
