1111111111111
1C010C0000C01
100100010E001
1000010111111
101111001C001
10P0010010001
100C0100000C1
1111111111111
