1111111111111
1C1C000000001
1000011111001
1P00110E00001
1111111111111