1111111111111
1000000000001
1000011111C01
1P0011E0000C1
1111111111111