1111111111111111111111111111111111
100C0000000000000000000C0000000001
1010001010000100001111000001000001
1010010010001010001000100010100001
1010100010001010001000100010100001
1011000010010001001111000100010001
1010100010011111001010000111110001
1010010010100000101001001000001001
1010001010100000101000101000001001
1000000000000000000000000000000001
10000P0C000000000000000000000E0001
100000000000000000C000000000000001
1111111111111111111111111111111111